1
Enterprise - ѕредпри€ти€
No Matter - Ќеважно
achieve - достижени€
almost - почти
approach - подход
bind - прив€зать
callous - мозолить
circumstance - обсто€тельством
comparison - сравнение
dare - смею
depend - зависит
devote - посв€тить
downplay - приуменьшить
each - каждый
endeavors - начинани€х
even - даже
excitement - волнение
incident - инцидент
indeed - действительно
inordinate - чрезмерное
investigate - расследование
jade - ƒжейд
juggling - жонглирование
lazy - ленивый
less - меньше
manner - образом
mean - значит
measure - меру
merely - просто
mind-bogglingly - умопомрачительно
mundane - приземленные
nutshell - двух словах
obsession - одержимость
own - собственного
particular - особое
permit - разрешение
provoke - спровоцировать
rather - а
reason - причина
receive - получите
remarkably - удивительно
require - требуетс€
seem - кажетс€
shrine - храм
significant - значительное
suggest - предлагаю
suppose - предположим
surface - поверхность
throughout - по всей
variety - разнообразие
vomit - блевотина
wide - широкий
