1
aching - ломит
aware - известно
banished - изгнан
bid - предложение
blame - виноват
burden - бремя
description - описание
farewell - прощание
force - силу
forlorn - несчастным
impending - надвигающейся
lay - лей
levity - легкомыслие
life-decisions - жизнь-решений
lifeward - lifeward
meadow - лужок
mean - значит
minor - незначительные
misery - убожество
peaceful - мирное
placid - плесид
premonition - предчувствие
provide - обеспечить
reach - достичь
rest - остальное
sealed - запечатанный
shores - берега
stain - пятно
still - еще
strife - рознь
summoners - призыватели
timid - робкие
unheard - неслыханно
suspect - подозрение
vain - зря
ward - Уорд
wish - желаю
