1
Panzer - танк
abhorrence - отвращение
carrion - падаль
christraping - христонасилующий
consider - рассмотрим
crow - ворона
dare - смею
doom - дум
enchanted - зачарованная
enrapture - восхищать
exile - ссылку
fill - заполнить
gentle - нежный
grief - горе
hurt - больно
indeed - действительно
inferior - уступает
jester - шут
moan - стон
mourn - скорбим
overcome - преодолеть
pervert - извращенец
pleasure - удовольствие
praise - хвала
pulverized - пылевидного
revolt - восстание
scorn - презрение
scourge - бедствием
shepherd - пастух
sould - может
urge - призываю
weep - плакать
